###############################################
#                      #                      #
#                      #                      #
#     #          #     #    #          #      #
#                      #                      #
#     #          #     #    #          #      #
#     #          #     #    #          #      #
#                      #                      #
#                      #                      #
#     #          #     #    #          #      #
#                      #                      #
#                      #                      #
#     #          #     #    #          #      #
#     #          #     #    #          #      #
#                      #                      #
#                      #                      #
#     #          #     #    #          #      #
#                      #                      #
#                      #                      #
###############################################