###############################
#                             #
#   i                         #
#####             #       i   #
#                 #           #
#                             #
#                 ######      #
#     #####                   #
#                             #
#           #                 #
#      i    #                 #
#           #                 #
###############################
