############################
#            i             #
#     #####..          ..  #
#         # .     ####     #
#  ..     #      .   #  .  #
#     .     .        #     #
#     ###                  #
#                 #   .    #
#   . #    .    #####  .   #
#     #          .#        #
#  .       i    ..#   ..   #
#                          #
#                          #
#                          #
#                          #
############################