###############################
#                             #
#                             #
#####             #           #
#                 #           #
#                             #
#                 ######      #
#     #####                   #
#                             #
#           #                 #
#           #                 #
#           #                 #
###############################
