############################
#                          #
#     #####..          ..  #
#         # .     ####     #
#  ..     #      .   #  .  #
#     .     .        #     #
#     ###                  #
#     #           #   .    #
#   . #    .    #####  .   #
#     #          .#        #
#  .            ..#   ..   #
# .. .                     #
############################