###############################
#                             #
#                             #
#####             #           #
#                 #           #
#                             #
#                 ######      #
#     #####                   #
#                             #
#         #                   #
#         #                   #
#         #                   #
###############################
