#################################
#                               #
#                               #
#                       #       #
#                       #       #
#                       #       #
#                               #
#            i                  #
#                               #
#          ###                  #
#                               #
#                     #         #
#                     #         #
#                     #         #
#                               #
#                               #
#                               #
#################################