############/################################
#.........../...............................#
#.........../...............................#
#...........................................#
#.........../...............................#
#.........../...............................#
#.........../...............................#
#.........../...............................#
############/################################