############################################
#        i               #        #        #
#                        #        #   i    #
####### b                #        #        #
#                        #        # ###    #
#                        #                 #
#                                          #
#                                          #
#       #######                            #
#                     i                    #
#    i       #               #######  b    #
#            #                             #
#            #                     #       #
# ####       #     #########       #       #
#                                  #       #
###                                        #
#                         i                #
#                                          #
############################################