############################
#            i             #
#     #####..          ..  #
#         # .     ####     #
#  ..     #      .   #  .  #
#     .     .        #     #
#     ###                  #
#                     .    #
#   . #    .    #####  .   #
#     #          .#        #
#  .       i    ..#   ..   #
#                 #        #
#         #                #
#         #                #
#         #                #
#         #                #
############################